JPZ = "countries/JPZ.txt"
OGT = "countries/OGT.txt"
OBG = "countries/OBG.txt"
OLB = "countries/OLB.txt"
OIC = "countries/OIC.txt"
SHC = "countries/SHC.txt"
RBG = "countries/RBG.txt"
RGR = "countries/RGR.txt"
RBL = "countries/RBL.txt"
RNT = "countries/RNT.txt"
RDN = "countries/RDN.txt"
RNW = "countries/RNW.txt"
RBM = "countries/RBM.txt"
RGV = "countries/RGV.txt"
RUA = "countries/RUA.txt"
ROT = "countries/ROT.txt"
RMK = "countries/RMK.txt"
RDW = "countries/RDW.txt"
RTK = "countries/RTK.txt"
RKS = "countries/RKS.txt"
RSV = "countries/RSV.txt"
RHG = "countries/RHG.txt"
RRO = "countries/RRO.txt"
RTS = "countries/RTS.txt"
RBA = "countries/RBA.txt"
RCR = "countries/RCR.txt"
RSB = "countries/RSB.txt"
RAB = "countries/RAB.txt"
RUK = "countries/RUK.txt"
RSC = "countries/RSC.txt"
RWL = "countries/RWL.txt"
RCW = "countries/RCW.txt"
RFC = "countries/RFC.txt"
RIE = "countries/RIE.txt"
RSW = "countries/RSW.txt"
RFD = "countries/RFD.txt"
RSP = "countries/RSP.txt"
RBQ = "countries/RBQ.txt"
RAG = "countries/RAG.txt"
RPT = "countries/RPT.txt"
RWS = "countries/RWS.txt"
RES = "countries/RES.txt"
RNH = "countries/RNH.txt"
RTU = "countries/RTU.txt"
RAR = "countries/RAR.txt"
RNA = "countries/RNA.txt"
RMA = "countries/RMA.txt"
RSF = "countries/RSF.txt"
REF = "countries/REF.txt"
RMG = "countries/RMG.txt"
RIT = "countries/RIT.txt"
RSZ = "countries/RSZ.txt"
RPR = "countries/RPR.txt"
RID = "countries/RID.txt"
RIN = "countries/RIN.txt"
ROA = "countries/ROA.txt"
ROZ = "countries/ROZ.txt"
RQU = "countries/RQU.txt"
RCD = "countries/RCD.txt"
RAM = "countries/RAM.txt"
RCS = "countries/RCS.txt"
RPZ = "countries/RPZ.txt"
RMX = "countries/RMX.txt"
RCB = "countries/RCB.txt"
RCL = "countries/RCL.txt"
RBZ = "countries/RBZ.txt"
RGT = "countries/RGT.txt"
REC = "countries/REC.txt"
RWC = "countries/RWC.txt"
RMO = "countries/RMO.txt"
RMC = "countries/RMC.txt"
RKR = "countries/RKR.txt"
RJP = "countries/RJP.txt"
RPO = "countries/RPO.txt"
RAD = "countries/RAD.txt"
RUL = "countries/RUL.txt"
RCX = "countries/RCX.txt"
REY = "countries/REY.txt"
RGL = "countries/RGL.txt"
RSD = "countries/RSD.txt"
RWF = "countries/RWF.txt"
RTZ = "countries/RTZ.txt"
RZA = "countries/RZA.txt"
RPE = "countries/RPE.txt"


#### RUSSIA COLLAPSE ####

KZN = "countries/KZN.txt"
TRK = "countries/TRK.txt"
TRC = "countries/TRC.txt"
WRS = "countries/WRS.txt"
SBI = "countries/SBI.txt"
WRA = "countries/WRA.txt"